IT1

release 0.1 - January 2001
__________________________

it1 - An italian male voice for the MBROLA synthesiser

PHONEME	IN WORD     IN SAMPA                              
A		sapere	/"sapere/	                              
A2		cane        /"kane/                              
E		sera        /"sera/                              
E1		messa		/"mEssa/
E2	      rete 		/"rete/                              
I	      unico		/"uniko/
I2		pino		/"pino/
O		sono		/"sono/
O1		moto		/"mOto/                              
O2		come        /"kome/                              
U		unità		/unit"a/                              
U2		fumo		/"fumo/                              

J		ieri		/"jEri/                              
W		uomo        /"wOmo/                              

P		papà	      /pa"pa/            
T		tana	      /"tana/            
K		cane		/"kane/                
B		bene		/"bene/                   
D		dove		/"dove/                           
G		gola 		/"gola/                      

PP		pappa		/"pappa/                     
TT		otto		/"otto/                     
KK		pakko	      /"pakko/                     
BB		abbonato 	/abbo"nato/                   
DD		addato	/add"ato/                 
GG	      leggo		/"lEggo/                          

ts		forza		/"fOrtsa/                     
dz		zero		/"dzEro/                    
ch		cena		/"tSena/                   
gh		gente		/"dZEnte/    
TS		pezzo	      /"pEttso/            
DZ		azzurro	/a"ddzurro/            
CH		accesso	/a"ttSEsso/                
GH		maggio	/"maddZo/
                   
F		forza		/"fOrtsa/                           
V		vela 		/"vela/                      
S		sole	      /"sole/            
Z		snob, rosa	/"znOb/, /"rOza/            
sh		sci		/"Si/
                
FF		effe		/"Effe/                   
VV		avvento	/a"vvEnto/                           
SS		sasso 	/"sasso/                   
SH		conoscere	/ko"noSSere/
            
M		mano	      /"mano/            
N		nano		/"nano/                
gn		gnomo		/"Jomo/                   
ng		gong		/"goN/
                           
MM		mamma 	/"mamma/                                  
NN          venne       /"vEnne/
GN		giugno	/"dZuJJo/     
       
L		lana		/"lana/                
gl		gli		/"Li/                   
R		rana		/"rana/
                           
LL		palla 	/"palla/                                  
GL		aglio		/"aLLo/                              
RR		erre        /"Erre/                              


Contact:
--------
Diphones provided by Claudia Citta <ccitta@hotmail.be>
Faculté Polytechnique de Mons, TCTS Lab
Initialis Scientific Parc, Avenue Copernic
B7000 MONS
Belgium


